1111111111
1C00010001
11E00001P1
1111111111
1111111111