





NO assets/NO.xpm fddfdfd



SO assets/SO.xpm

WE assets/WE.xpm

EA assets/EA.xpm

F 98,105,255
C 80,130,202
               
             
                      1
    111111        1111011111111111111     
   10000001       10000000000000001      
   10000001       10000000000000001      
  1000001001110000001000000001      
 100000101000000000000000001
10000000100000000000000001
 1000000000001000000000001
  1000000000000000000000001
   1000000000000000000000001
  1000000000000000000000001
 100000000000N000000000001
1111111111111111111111111