





NO assets/NO.xpm fddfdfd



SO assets/SO.xpm

WE assets/WE.xpm

EA assets/EA.xpm

F 98,105,255
C 80,130,202
               
             
 1           111
 11          1  1
1  1         1   1
1   1        1   1
1    1       1    111111
1     1      1          11
1      111  1 11         1111111111111
1     1   11 1111                1111
 1   1   11   11           111111
  1  1  1   1     1   1111 1
   1 1 1              1111 1
111  11         1111      1
1   1  1         11    1  1
 1   1 1                 1
  1  1 1                11
   1 11                   11
    11                 11   1
    1                 1  1   1
   1                 1    1111
  1                   1
  1                    1
  1     11111111       1
   1  11        11    1
   1  1           100011
  1111             11111111